1111111111
1000P00001
10E0000C01
100C000001
1111111111