1111111111
1000P00001
10E0000C01
1000000001
1000C00001