1111111111
1000000001
10E0000C01
100000C001
1111111111