1111111101
10000P0001
10E0000C01
100000C001
1111111111