1111111111
10000P0001
10E0000C01
100000C000
1111111111