111111111
100000000000000000001
111111111